108,26
000000000000000000000000000000000000000000000000000000000000000000000000000000000000000000000000000000000000
00__00000000000000000000000000000000000000000000000000000000000000000000000000000000000000000000000000000000
000000000000000000000000000000000000000000000000000000000000000000000000000000000000000000000000000000000000
000000000000000000000000000000000000000000000000000000000000000000000000000000000000000000000000000000000000
0000000000000000000000000000000000000000000000000000000000()000000()0000000000000000000000000000000000000000
000000000000000000000000000000000000000000000000000000()000000()00000000000000000000000000000000000000000000
]000000000000000000000000()00000000000000000000()00000000000000000000000g00000000000000000000000000000000000
!000000000000000000[--]000000000g000(_)000000000000()0000000000000000[------]0000000000000000000000000000000
!0000000000000()000i''!000000(___)00000000[---]000000000000000000()00i''''''!0000000000000000000000000000000
!00000000(_)00000g0i''}-]00000000000000000i'''!0000000000000(_)000000i''''''!0000000000000000000000000000000
!0000s00000g0(___)0i''''!g0000000000b000[-{'''!00000000000g00000000()i''''''!00000000000g0000000g000000000[-
!00(__)000000000000i''''}--]0000000(__)0i'''''!0000000000000000000000i''''''!00000000000000000000000000000i'
!0000b0000000000000i'''''''!00000g000000i'''''!0000000000000000(_)000i''''''!00000000000000000000000000000i'
}------------------{'''''''!000(__)00b00i'''''!0000000000(__)00000000i''''''!00000000000000(__)00000(__)00i'
'''''''''''''''''''''''''''!000000000000i'''''!000000(_)0000000000000i''''''}--------]00000000000000000000i'
'''''''''''''''''''''''''''}------------{'''''!00000000000000[-------{'''''''''''''''!00000000000000000000i'
''''''''''''''''''''''''''''''''''''''''''''''!000000g0000000i'''''''''''''''''''''''!0000000000(__)000000i'
''''''''''''''''''''''''''''''''''''''''''''''!0000000000(_)0i'''''''''''''''''''''''!00000000000000000000i'
''''''''''''''''''''''''''''''''''''''''''''''!000(_)00000000i'''''''''''''''''''''''!000(__)000000000[---{'
''''''''''''''''''''''''''''''''''''''''''''''}-]00000(_)0000i'''''''''''''''''''''''!0000000000000000i'''''
''''''''''''''''''''''''''''''''''''''''''''''''!000000000000i'''''''''''''''''''''''!0000000000000000i'''''
''''''''''''''''''''''''''''''''''''''''''''''''}------------{'''''''''''''''''''''''}----------------{'''''
''''''''''''''''''''''''''''''''''''''''''''''''''''''''''''''''''''''''''''''''''''''''''''''''''''''''''''
''''''''''''''''''''''''''''''''''''''''''''''''''''''''''''''''''''''''''''''''''''''''''''''''''''''''''''
''''''''''''''''''''''''''''''''''''''''''''''''''''''''''''''''''''''''''''''''''''''''''''''''''''''''''''
''''''''''''''''''''''''''''''''''''''''''''''''''''''''''''''''''''''''''''''''''''''''''''''''''''''''''''
